音效切换到人生	音效切换到人声
音效调成人生	音效调成人声
至热	制热
农一点	浓一点
hd	hud
野关闭	也关闭
野关一下	也关一下
野关上	也关上
野开	也开
耶关	也关
耶开	也开
野打开	也打开
耶打开	也打开
野大一点	也大一点
野小一点	也小一点
耶大一点	也大一点
耶小一点	也小一点
风潮我吹	风朝我吹
住家温度	主驾温度
行车模式	醒神模式
象山模式	醒神模式
hi蓝牙	开蓝牙
hi wifi	开wifi
hi热点	开热点
hi启	开
hi开	开
hi空调	开空调
hi灯光	开灯光
hi后备箱	开后备箱
座椅记忆钥匙绑定	座椅记忆与钥匙绑定
座椅及钥匙绑定	座椅记忆与钥匙绑定
座椅与钥匙绑定	座椅记忆与钥匙绑定
training吹脚	吹脸吹脚
training	吹脸
歙县提速	设限提速
座椅及人脸识别	座椅记忆与人脸识别
座椅记忆人脸识别	座椅记忆与人脸识别
座椅与人脸识别	座椅记忆与人脸识别
进入设呗	进入设备
后背箱	后备箱
外界设备	外接设备
宝宝客户模式	宝宝呵护模式
要是智能解锁	钥匙智能解锁
手动校准日期时间见面	手动校准日期时间界面
石狮导航	实时导航
空调中风	空调送风
ok设置	lka设置
高龄点五	高零点五
pe投屏	pad投屏
pie投屏	pad投屏
PM2点5	PM2.5
pm2点5	pm2.5
第一度	低一度
第二度	低二度
第三度	低三度
第四度	低四度
第五度	低五度
第六度	低六度
第七度	低七度
第八度	低八度
第九度	低九度
第十度	低十度
第十五度	低十五度
第二十度	低二十度
0	零
1	一
2	二
3	三
	
瓮	
唉瓮	
嗯	
度	
度	
度	
度	
哦	
